10
15
aOOOOOOOOOOOOOO
bOOOOOOOOOOOOOO
cOOOOOFGHOOOOOO
dOOOOOIJKOOOOOO
eOOOOOOOOOOOOOC
fOOOOOOOOOOOOOB
gOOOOOOOODOOOOA
hOOOOOOOOEOOOOz
iOOOOOOOOOOOOOy
jklmnopqrstuvwx
